Back=Zurück
BackBig=Zurück
Close=Schließen
CloseBig=Schließen
Upgrade=Verbessern
UpgradeBig=Verbessern
MenuProfile=PROFIL
MenuShips=RAUMSCHIFFE
MenuShop=LADEN
MenuArena=ARENA
MenuMission=MISSION
Claim=Abholen
DailyRewardsComeBackIn=Komm zurück in {0} für deine nächste Belohnung
DayN=Tag {0}
Credits=Kredite
CanClaimReward=Sie können Ihre Belohnung einfordern!
YouGotX=Sie haben {0}!
YouGotNX=Sie haben {0} {1}!
ProfileTitle=MEIN PROFIL
ChangeName=NAMEN ÄNDERN
ChangeNameFor=NAMEN ÄNDERN FÜR
ShipFighter=KÄMPFER
ShipRogue=SCHURKE
ShipDefender=VERTEIDIGER
RespawnIn=Respawn in: {0}
CapturedNexus=hat Nexus erobert!
CapturingNexus=erobert Nexus!
DronesKilled=Drohnen getötet: {0}/{1}
NexusCaptured=Nexus gefangen: {0}/{1}
Place=Platz!
SuffixTh= 
SuffixSt= 
SuffixNd= 
SuffixRd= 
PlayersReady=Spieler bereit zu kämpfen: {0}/{1}
TutorialLeftJoystick=Verwenden Sie den linken Joystick, um Ihr Schiff zu bewegen!
TutorialRightJoystick=Verwenden Sie den rechten Joystick, um Ihre Waffe zu drehen!
TutorialArena=Gehen Sie zum Nexus im Arena-Center und versuchen Sie, es zu erobern!
TutorialMission=Erobere den Nexus auf der rechten Seite dieses Bereichs und töte alle Drohnen auf dem Weg!
FirstTutorial1=Willkommen im Hangar, Held! Hier können Sie Ihren Namen ändern, wenn Sie möchten
FirstTutorial2=Hier kannst du deine Raumschiffsammlung finden und eines davon für die nächste Schlacht auswählen!
FirstTutorial3=Wenn Sie gerne gegen andere Spieler spielen, wechseln Sie zu Arena. Versuchen Sie, den Nexus zu erobern, um sofort zu gewinnen!
FirstTutorial4=Oder Sie können versuchen, die Mission abzuschließen
LoadingScreen_Server=CONNECTING TO SERVER...
LoadingScreen_GP=CONNECTING TO GOOGLE PLAY...
LoadingScreen_SigningIn=SIGNING IN...
LoadingScreen_LoadingProfile=LOADING PROFILE...
LoadingScreen_Connecting=CONNECTING TO MASTER SERVER...
WarningNicknameShort=Dein Spitzname ist zu kurz!
WarningNicknameTaken=Dieser Spitzname ist schon in Gebrauch!
WarningNotEnoughMoney=Nicht genug Geld!
LoadingScreen_FindingRoom=SPIEL FINDEN...
LoadingScreen_StartingMission=MISSION STARTEN...
LoadingScreen_LoadingHangar=LADEN HANGAR...
HasEnteredGame={0} hat das Spiel betreten
Buy=KAUFEN
Leave=Verlassen
MissionFailedTitle=MISSION FEHLGESCHLAGEN!
MissionCompletedTitle=AUFTRAG ERLEDIGT!
VictoryTitle=SIEG
DefeatTitle=VERLUST
DailyRewardsTitle=Tägliche Belohnungen
UpgradeScreenTitle=RAUMSCHIFF-UPGRADE
StatCritChance=Krit. Chance: {0}%
StatCritDamage=Krit. Schaden: {0}%
Absorbed=AUFGENOMMEN
Dodge=AUSWEICHEN
SkinTitle_IceBombs=Eisbomben
SkinTitle_DarkDeath=Dunkler Tod
SkinDesc_IceBombs=Bomben wie Eissterne!
SkinDesc_DarkDeath=Stirb mit dunklem Geheimnis!
Unlocked=ENTSPERRT