Back=Назад
BackBig=НАЗАД
Close=Закрити
CloseBig=ЗАКРИТИ
Upgrade=Апгрейд
UpgradeBig=АПГРЕЙД
MenuProfile=ПРОФІЛЬ
MenuShips=КОРАБЛІ
MenuShop=КРАМНИЦЯ
MenuArena=АРЕНА
MenuMission=МІССІЯ
Claim=ОТРИМАТИ
DailyRewardsComeBackIn=Повертайся через {0} для наступної нагороди
DayN=День {0}
Credits=Кредити
CanClaimReward=Ти можеш отримати свою нагороду!
YouGotX=Отримано {0}!
YouGotNX=Отримано {0} {1}!
ProfileTitle=МІЙ ПРОФІЛЬ
ChangeName=ЗМІНИТИ ІМ'Я
ChangeNameFor=ЗМІНИТИ ІМ'Я ЗА
ShipFighter=ВИНИЩУВАЧ
ShipRogue=РОЗБІЙНИК
ShipDefender=ЗАХИСНИК
RespawnIn=Повератємось у бій через: {0}
CapturedNexus=захопив Нексус!
CapturingNexus=захоплює Нексус!
DronesKilled=Дронів вбито: {0}/{1}
NexusCaptured=Нексус захоплено: {0}/{1}
Place=Місце!
SuffixTh=е
SuffixSt=ше
SuffixNd=ге
SuffixRd=тє
PlayersReady=Гравців готових до бою: {0}/{1}
TutorialLeftJoystick=Використовуй лівий джойстик для руху
TutorialRightJoystick=Використовую правий джойстик для контролю зброї
TutorialArena=Лети у центр Арени до Нексусу та спробуй захопити його!
TutorialMission=Захопи Нексус у правій частині території та знищи усіх дронів на своєму шляху!
FirstTutorial1=Ласкаво просимо у Ангар, герою! Тут ти можешь змінити своє ім'я, якщо забажаєш
FirstTutorial2=А тут ти можеш знайти свою колекцію кораблів та обрати один з них для наступного бою
FirstTutorial3=Якщо тобі до вподоби бої проти інших гравців, тоді вперед на Арену! Спробуй захопити там Нексус для швидкої перемоги
FirstTutorial4=Або ж ти можеш спробувати виконати Місію
LoadingScreen_Server=ПІДКЛЮЧАЄМОСЬ ДО СЕРВЕРУ...
LoadingScreen_GP=ПІДКЛЮЧАЄМОСЬ К GOOGLE PLAY...
LoadingScreen_SigningIn=АВТОРИЗУЄМОСЬ...
LoadingScreen_LoadingProfile=ЗАГРУЖАЄМО ПРОФІЛЬ...
LoadingScreen_Connecting=ПІДКЛЮЧАЄМОСЬ ДО ІГРОВОГО СЕРВЕРУ...
WarningNicknameShort=Ім'я занадто коротке!
WarningNicknameTaken=Це ім'я вже використовується!
WarningNotEnoughMoney=Недостатньо грошей!
LoadingScreen_FindingRoom=ПОШУК КІМНАТИ...
LoadingScreen_StartingMission=ЗАПУСК МІСІЇ...
LoadingScreen_LoadingHangar=ЛЕТИМО У АНГАР...
HasEnteredGame={0} входить у гру
Buy=КУПИТИ
Leave=Вийти
MissionFailedTitle=МІСІЯ ПРОВАЛЕНА!
MissionCompletedTitle=МІСІЯ ВИКОНАНА!
VictoryTitle=ПЕРЕМОГА
DefeatTitle=ПОРАЗКА
DailyRewardsTitle=Щоденні Нагороди
UpgradeScreenTitle=АПГРЕЙД КОРАБЛЯ
StatCritChance=Крит. шанс: {0}%
StatCritDamage=Крит. урон: {0}%
Absorbed=ПОГЛОЩЕНО
Dodge=УВОРОТ
SkinTitle_IceBombs=Крижані Бомби
SkinTitle_DarkDeath=Темна Смерть
SkinDesc_IceBombs=Бомби як крижані зірки!
SkinDesc_DarkDeath=Помирай із темною загадкою!
Unlocked=ОТРИМАНО
SelectLangTitle=Обери мову:
Reward=Нагорода