Back=Назад
BackBig=НАЗАД
Close=Закрыть
CloseBig=ЗАКРЫТЬ
Upgrade=Улучшить
UpgradeBig=УЛУЧШИТЬ
MenuProfile=ПРОФИЛЬ
MenuShips=КОРАБЛИ
MenuShop=МАГАЗИН
MenuArena=АРЕНА
MenuMission=МИССИЯ
Claim=ПОЛУЧИТЬ
DailyRewardsComeBackIn=Возвращайся через {0} для след. награды
DayN=День {0}
Credits=Кредиты
CreditsGot=кредитов
CanClaimReward=Ты можешь получить свою награду!
YouGotX=Получено {0}!
YouGotNX=Получено {0} {1}!
ProfileTitle=МОЙ ПРОФИЛЬ
ChangeName=ИЗМЕНИТЬ ИМЯ
ChangeNameFor=ИЗМЕНИТЬ ИМЯ ЗА
ShipFighter=ИСТРЕБИТЕЛЬ
ShipRogue=РАЗБОЙНИК
ShipDefender=ЗАЩИТНИК
RespawnIn=Возвращаемся в бой через: {0}
CapturedNexus=захватил Нексус!
CapturingNexus=захватывает Нексус!
DronesKilled=Дронов убито: {0}/{1}
NexusCaptured=Нексус захвачен: {0}/{1}
Place=Место!
SuffixTh=ое
SuffixSt=ое
SuffixNd=ое
SuffixRd=е
PlayersReady=Игроков готово к сражению: {0}/{1}
TutorialLeftJoystick=Используй левый джойстик чтобы двигаться
TutorialRightJoystick=Используй правый джойстик для управления оружием
TutorialArena=Лети в центр Арены к Нексусу и попытайся захватить его!
TutorialMission=Захвати Нексус в правой части карты и уничтожь дронов по пути!
FirstTutorial1=Добро пожаловать в Ангар, герой! Здесь ты можешь поменять свое имя, если пожелаешь
FirstTutorial2=Здесь ты можешь найти свою коллекцию кораблей и выбирать один из них для следующего сражения!
FirstTutorial3=Если ты предпочитаешь сражения против других игроков, то вперед на Арену! Захвати там Нексус, чтобы мгновенно победить
FirstTutorial4=Либо можешь испытать свои силы в Миссии
LoadingScreen_Server=ПОДКЛЮЧАЕМСЯ К СЕРВЕРУ...
LoadingScreen_GP=ПОДКЛЮЧАЕМСЯ К GOOGLE PLAY...
LoadingScreen_SigningIn=ВХОДИМ В ИГРОВОЙ МИР...
LoadingScreen_LoadingProfile=ЗАГРУЖАЕМ ПРОФИЛЬ...
LoadingScreen_Connecting=ПОДКЛЮЧАЕМСЯ К ИГРОВОМУ СЕРВЕРУ...
WarningNicknameShort=Имя слишком короткое!
WarningNicknameTaken=Это имя уже занято!
WarningNotEnoughMoney=Недостаточно денег!
LoadingScreen_FindingRoom=ПОИСК КОМНАТЫ...
LoadingScreen_StartingMission=ЗАПУСК МИССИИ...
LoadingScreen_LoadingHangar=ЛЕТИМ В АНГАР...
HasEnteredGame={0} входит в игру
Buy=КУПИТЬ
Leave=Выйти
MissionFailedTitle=МИССИЯ ПРОВАЛЕНА!
MissionCompletedTitle=МИССИЯ ВЫПОЛНЕНА!
VictoryTitle=ПОБЕДА
DefeatTitle=ПОРАЖЕНИЕ
DailyRewardsTitle=Ежедневные Награды
UpgradeScreenTitle=УЛУЧШЕНИЕ КОРАБЛЯ
StatCritChance=Крит. шанс: {0}%
StatCritDamage=Крит. урон: {0}%
Absorbed=ПОГЛОЩЕНО
Dodge=УВОРОТ
SkinTitle_IceBombs=Ледяные Бомбы
SkinTitle_DarkDeath=Темная Смерть
SkinDesc_IceBombs=Бомбы как ледяные звезды!
SkinDesc_DarkDeath=Умирай с мрачной загадкой!
Unlocked=ПОЛУЧЕНО
SelectLangTitle=Выбери язык:
Reward=Награда
Notification_DailyReward=Возвращайся в Ангар, герой! Твоя ежедневная награда ждет тебя!
Nickname=Ваш никнейм:
or=или
OrLoginVia=или вход через
SignUpBig=РЕГИСТРАЦИЯ
LoginBig=ВОЙТИ
CreateAccount=СОЗДАТЬ АККАУНТ
UpgradeTitle_improved_bullets=Улучшенные Снаряды
UpgradeDesc_improved_bullets=Твое оружие будет наносить +1 доп. урона за каждый ур. улучшения
UpgradeTitle_forward_to_battle=Вперед в бой!
UpgradeDesc_forward_to_battle=Время возвращения в бой уменьшено на 10% за каждый ур. улучшения
UpgradeTitle_precise_shots=Точные Выстрелы
UpgradeDesc_precise_shots=Крит. шанс увеличен на 3% за каждый ур. улучшения
UpgradeTitle_confident_offensive=Уверенное Наступление
UpgradeDesc_confident_offensive=Скорость полета и макс. заряд энергощита увеличены на 20%
UpgradeTitle_hidden_killer=Скрытный Убийца
UpgradeDesc_hidden_killer=Во время невидимости скорость полета увеличена на 10% за каждый ур. улучшения
UpgradeTitle_sudden_shot=Внезапный Выстрел
UpgradeDesc_sudden_shot=Первый выстрел из состояния невидимости наносит гарантированный крит. урон
UpgradeTitle_search_vulnerabilities=Поиск Уязвимостей
UpgradeDesc_search_vulnerabilities=Крит. урон увеличен на 20% за каждый ур. улучшения
UpgradeTitle_improved_stealth=Улучшенная Скрытность
UpgradeDesc_improved_stealth=Длительность невидимости увеличена на 25%
UpgradeTitle_enhanced_armor=Улучшенная Броня
UpgradeDesc_enhanced_armor=Прочность увеличена на 10% за каждый ур. улучшения
UpgradeTitle_improved_shield=Улучшенный Щит
UpgradeDesc_improved_shield=Регенерация энергощита увеличена на 20% за каждый ур. улучшения
UpgradeTitle_unshakeable_defender=Непоколебимый Защитник
UpgradeDesc_unshakeable_defender=Корабль неуязвим 2 доп. секунды после возвращения в бой
UpgradeTitle_enhanced_repair=Улучшенный Ремонт
UpgradeDesc_enhanced_repair=Ремонт восстанавливает на 40% больше прочности